2 16 5602 5625 1153 1224 2834 740 2053 5595 5567 5536 2046 1189 5561 5588 1303 1803 
1 23 5602 1573 1552 1811 5458 5423 2050 5327 5274 5232 444 5119 762 1938 1920 4899 2694 4854 1897 4803 4739 4698 4669 
1 18 5602 1573 5547 5546 2343 2755 1020 1107 5352 5314 1789 5216 2461 5157 5129 5095 566 5015 
1 16 5602 5643 5662 2825 5764 5798 5834 2670 158 5925 1759 2376 1193 6051 6091 287 
1 5 762 1893 5052 5053 999 
1 10 762 5079 5111 5142 1608 5118 268 1494 5185 5216 
1 13 4739 2282 4681 617 4614 4612 1223 233 2473 4522 4515 826 4499 
1 20 5015 1694 4926 423 4844 2838 4771 2627 1620 4650 4619 4569 4526 2519 2492 248 4403 1577 4310 4223 
3 12 1073 1028 4391 4436 858 1690 4483 1207 4540 2848 4541 2880 
2 14 4469 4506 4534 4562 2497 2446 4510 4528 493 4548 2133 4477 4450 4419
1 7 4390 4351 4316 4283 2405 4214 1863
1 16 1565 1174 4472 1590 4428 4404 4377 4348 4315 976 123 4178 4159 509 1314
2 8 4229 4274 1372 4263 4224 4203 2637 4143