2 30 5602 1573 1552 1811 5458 5423 2050 5327 5274 5232 444 5119 762 1938 1920 4899 2694 4854 1897 4803 4739 4698 4669 4682 2344 2598 4582 4551 136 1174 
2 18 5602 1573 5547 5546 2343 2755 1020 1107 5352 5314 1789 5216 2461 5157 5129 5095 566 5015 
2 17 5602 5643 5662 2825 5764 5798 5834 2670 158 5925 1759 2376 1193 6051 6091 287 6186 
1 15 762 1893 5052 5053 999 5017 4988 4954 1662 4882 2490 4811 4794 6776 4732 
1 10 762 5079 5111 5142 1608 5118 268 1494 5185 5216 
1 18 4739 2282 4681 617 4614 4612 1223 233 2473 4522 4515 826 4499 461 4446 4441 4389 4348 
1 20 5015 1694 4926 423 4844 2838 4771 2627 1620 4650 4619 4569 4526 2519 2492 248 4403 1577 4310 4223 
3 14 1073 1028 4391 4436 858 1690 4483 1207 4540 2848 4541 4511 2880 4571 
2 15 4469 4506 4534 4562 4529 2497 2446 4510 4528 493 4548 2133 4477 4450 1341 
1 8 1341 1862 4349 4316 4283 2405 4214 1863 
1 18 4548 1565 1174 4472 1590 4467 4449 4428 4404 4377 4348 4315 976 123 4178 4159 509 1314 
2 3 457 4558 4540 
3 10 4540 4558 2243 2332 4628 4634 4666 4700 4740 4741 
4 6 4365 4345 1028 4364 4405 1073 
3 14 4558 457 4620 4654 4683 11433 4728 4783 2366 4815 4848 4873 4885 4917 
2 12 2074 4239 4267 4230 4250 2565 4336 4352 4372 2248 2065 4340 
1 7 1578 4864 4890 2172 4858 4885 4873 
1 7 5071 2636 4978 4981 4955 2334 4873 
1 10 5057 5018 1946 2624 4873 1256 4830 4815 870 4873 
1 9 2500 4806 4807 4795 2366 4783 804 4825 4858 
5 3 329 741 4740 
2 4 4666 4665 1584 4683 
1 9 329 1742 952 24 4784 4776 2286 4684 4659 
1 3 4741 1836 4675 
1 3 2521 5618 5602 
2 13 1573 1153 1224 2834 1326 2053 1751 5536 2046 903 1835 5532 5560 
1 6 2046 5489 2783 5414 2889 1107 
1 26 2627 4692 891 1689 2220 4588 2606 4549 859 4497 1787 4435 984 4411 916 1055 4276 4300 4321 261 2589 4309 87 4288 2563 4223 
1 24 1835 5448 5413 5377 1773 174 5306 5265 5231 5209 5175 2528 5128 5086 645 1305 2109 4934 4889 4853 4821 1157 4770 4771 
1 17 2217 4980 4966 1454 341 4940 4976 2070 1694 348 2786 5022 5041 5080 5116 2738 5175 
1 7 4954 4959 1032 2652 2103 4834 1256 
1 7 1690 63 4392 4359 1896 4278 2074 
2 38 4579 2781 4544 4447 4438 2661 196 4400 2106 4331 4292 1431 4222 831 1899 4134 4106 4105 4079 3992 1871 2392 3950 3926 3895 28 1771 3825 2006 1913 3816 49 2688 3889 3911 3936 3954 3972 
2 4 3950 3976 3989 3992 
1 17 3926 3914 880 392 3849 3824 710 2348 3766 3732 3713 1512 3615 3577 3540 2188 3549 
1 8 233 2164 4591 1615 4570 2381 2496 4526 
1 7 1787 1655 121 4615 1038 689 2571 
1 4 5352 2266 5310 5293 
1 7 5423 1060 2278 2539 5418 5415 5380 
1 9 5643 5686 5719 5694 5731 5724 1888 2064 5679 
1 29 196 2324 4330 4296 2422 4252 4212 339 4140 4114 1181 1281 4050 584 4036 1436 4086 4104 4133 4175 4205 4256 4280 1114 4281 1003 399 2647 4330 
1 65 3936 1544 3967 1169 3977 2268 3945 3946 906 3899 2870 3841 2430 3772 967 1597 3578 3587 3558 1973 995 3534 3510 915 3461 1065 1818 3374 2145 2791 652 3296 3276 3265 3262 2522 3261 336 3274 1561 3312 2858 3354 2616 3416 1984 3444 528 3428 3407 1087 3429 1209 3450 3481 2419 3542 2296 3565 454 3680 3720 3709 3754 2006 
1 39 3766 1037 1076 2062 3753 3771 3765 2754 3821 3802 3758 3729 3731 3707 3662 3631 3592 1522 3524 2297 3469 3442 1501 1530 2417 3316 3304 2445 3309 3326 3342 1249 2746 1161 3443 2790 2538 3515 3540 
3 6 4644 2760 4617 4647 4677 1023 
2 10 246 558 559 699 932 1854 427 669 5366 5385 
2 30 246 1315 1159 2888 1259 514 521 925 1085 1974 100 2073 928 3985 2327 1089 125 898 53 3422 184 2570 131 3249 538 1713 931 3215 2827 1242 
1 13 246 5492 5420 1039 1237 5590 5491 623 71 226 2246 173 5839 
1 12 246 558 5569 91 847 159 1523 633 1082 1869 413 1740 
1 14 2073 2752 3979 415 155 1056 834 401 130 523 1322 3256 166 1371 
1 9 2888 458 118 135 41 304 1376 1094 4373 
1 9 2888 318 809 810 4678 4622 552 4696 4796 
1 8 2327 896 142 1310 366 1555 387 2061 
1 35 220 934 273 2721 110 2991 545 613 1432 3024 1053 257 2110 1633 2126 1698 1021 301 3008 462 1064 1952 2952 292 2974 1034 625 1030 3021 3044 997 247 2351 3095 315 
1 15 220 612 468 2867 405 229 3181 1617 278 1639 806 942 2879 700 1371 
1 12 220 597 751 81 36 1607 948 1939 1379 349 1067 384 
1 21 278 3195 303 3208 606 2866 293 768 1785 644 250 30 1930 3249 291 1753 500 1409 2480 1827 2061 
1 31 278 3188 3180 3172 364 446 919 197 27 3168 83 470 653 2815 1499 478 1797 160 701 3132 181 1152 481 98 373 793 1837 88 2351 3095 315 
1 13 1499 1998 632 201 900 922 2271 2018 141 1024 2785 127 1813 
1 6 1030 217 240 1098 472 2355 
1 9 220 2408 1130 2946 717 2032 691 1027 2913 
1 19 792 1016 1539 2086 1988 280 3167 381 1379 398 1664 293 1351 377 3232 1444 460 1669 523 
1 14 2271 628 841 3197 2067 508 5 1918 638 330 237 843 3216 3217 
1 10 2110 1638 2729 1712 2938 620 1035 2929 51 1141 
1 8 2018 84 57 616 129 497 471 756 
1 4 793 895 2095 1636 
1 8 4522 794 4461 697 4382 4343 4313 976 
1 7 2344 2295 4711 4732 4744 1434 2500 
1 12 5430 1213 2007 6781 5419 5463 5502 5499 5490 5519 6782 6783 
1 21 4629 4594 4608 2442 4595 4623 4656 2655 4735 4703 4714 4734 1879 179 4641 1677 4660 4637 4606 2569 4607 
1 8 2618 4131 4162 4186 4155 823 1416 4065 
3 35 3053 3048 3043 3030 2028 3012 708 3011 3007 3003 2995 1600 3004 2502 1640 3017 3023 1963 1435 3042 3054 3071 3081 3091 308 3108 808 1914 3098 2035 3107 3100 1817 1937 3064 
1 2 3064 3053 
1 6 869 3061 3077 3088 2035 3107 
1 5 869 1917 1825 1963 1435 
1 8 869 3041 3050 3059 3049 3053 3048 3043 
1 4 869 2323 602 1600 
1 13 6386 6368 2873 2369 6280 6282 6264 6245 1109 6216 6195 905 6140 
1 3 6195 6169 6175 
1 9 6175 6179 6170 1182 1430 6176 86 6106 6066 
1 6 6175 1680 6094 1421 2068 825 
1 29 6342 1261 6407 1889 6460 6486 2603 6522 6514 1402 6566 640 6536 2610 1124 6462 6499 6498 6494 766 6513 6525 6544 2179 1900 769 6614 6630 2887 
1 15 6562 743 6571 1767 6573 2072 1704 520 165 6616 6613 334 6620 6603 6609 
1 9 6741 6744 2726 6738 6740 6743 6745 887 6734 
1 7 2726 6748 2807 6753 6754 6755 1965 
1 5 6738 6732 1994 1950 2312 
1 10 6648 1612 6657 6664 6671 6679 6684 2830 2262 6696 
1 13 1663 1575 2272 2313 1308 2687 6700 6692 2336 6678 6681 6683 6672 
1 12 6692 68 6682 6680 6669 6663 829 670 6652 871 802 6641 
1 4 670 6647 6642 2788 
1 7 1040 6490 6484 6512 6526 2892 6540 
1 5 6566 2201 6594 1510 6577 
1 5 6342 6336 2554 6371 6392 
1 11 4976 4935 4898 4839 973 4785 4754 4738 2117 4687 4650 
1 9 5052 5087 2515 5138 1215 764 5176 2350 5125 
1 4 5419 5384 5341 5308 
1 3 5519 5512 5475 
1 10 480 190 1463 3672 2509 3575 3552 1466 3465 1774 
1 6 480 3868 2740 172 3939 3938 
1 11 480 3869 1739 1676 3932 2131 1520 2476 4000 4008 635 
1 24 480 3814 3806 2596 3778 2894 3655 1368 3621 3582 2038 3522 982 3483 300 3487 2896 2719 3426 1230 3394 3385 3358 3335 
1 22 1774 3431 3419 3404 1572 3384 338 3405 3397 3393 3381 2302 3346 3355 3356 3357 3340 3325 1502 2628 1477 1230 
1 21 2476 2139 3957 3934 2883 3892 3871 485 2281 3775 2865 2818 3684 908 3636 2356 3530 1997 3455 2611 1230 
2 27 5662 2015 1012 5705 1487 5693 5685 5656 5650 5627 5588 5560 5535 2840 5472 5507 5506 944 5608 5633 5697 440 2183 5715 2630 5669 5627 
1 3 1803 5564 5560 
