3 14 1073 1028 4391 4436 858 1690 4483 1207 4540 2848 4541 4511 2880 4571 
1 20 4469 4506 4534 4562 4529 2497 2446 4510 4528 493 4548 2133 4477 4450 1341 2098 4415 1467 4491 1174 
1 8 1341 1862 4349 4316 4283 2405 4214 1863 
2 3 457 4558 4540 
3 10 4540 4558 2243 2332 4628 4634 4666 4700 4740 4741 
4 6 4365 4345 1028 4364 4405 1073 
3 14 4558 457 4620 4654 4683 11433 4728 4783 2366 4815 4848 4873 4885 4917 
2 12 2074 4239 4267 4230 4250 2565 4336 4352 4372 2248 2065 4340 
1 7 1578 4864 4890 2172 4858 4885 4873 
1 7 5071 2636 4978 4981 4955 2334 4873 
1 11 4873 870 4815 4830 1256 4873 2624 1946 5018 5057 5068 
1 9 2500 4806 4807 4795 2366 4783 804 4825 4858 
5 3 329 741 4740 
2 4 4666 4665 1584 4683 
1 9 329 1742 952 24 4784 4776 2286 4684 4659 
1 3 4741 1836 4675 
1 4 2652 2103 4834 1256 
1 7 1690 63 4392 4359 1896 4278 2074 
2 38 4579 2781 4544 4447 4438 2661 196 4400 2106 4331 4292 1431 4222 831 1899 4134 4106 4105 4079 3992 1871 2392 3950 3926 3895 28 1771 3825 2006 1913 3816 49 2688 3889 3911 3936 3954 3972 
2 4 3950 3976 3989 3992 
1 17 3926 3914 880 392 3849 3824 710 2348 3766 3732 3713 1512 3615 3577 3540 2188 3549 
1 29 196 2324 4330 4296 2422 4252 4212 339 4140 4114 1181 1281 4050 584 4036 1436 4086 4104 4133 4175 4205 4256 4280 1114 4281 1003 399 2647 4330 
1 55 3936 1544 3967 1169 3977 2268 3945 3946 906 3899 2870 3841 2430 3772 967 1597 3578 3587 3558 1973 995 3534 3510 915 3461 1065 1818 3374 2145 2791 652 3296 3276 3265 3262 2522 3261 336 3274 1561 3312 2858 3354 2616 3416 1984 3444 528 3428 3407 1087 3429 1209 3450 3481 
1 39 3766 1037 1076 2062 3753 3771 3765 2754 3821 3802 3758 3729 3731 3707 3662 3631 3592 1522 3524 2297 3469 3442 1501 1530 2417 3316 3304 2445 3309 3326 3342 1249 2746 1161 3443 2790 2538 3515 3540 
3 6 4644 2760 4617 4647 4677 1023 
2 10 246 558 559 699 932 1854 427 669 5366 5385 
2 7 246 1315 1159 2888 1259 514 521 
1 13 246 5492 5420 1039 1237 5590 5491 623 71 226 2246 173 5839 
1 12 246 558 5569 91 847 159 1523 633 1082 1869 413 1740 
1 5 2888 458 118 135 41 
1 9 2888 318 809 810 4678 4622 552 4696 4796 
1 35 220 934 273 2721 110 2991 545 613 1432 3024 1053 257 2110 1633 2126 1698 1021 301 3008 462 1064 1952 2952 292 2974 1034 625 1030 3021 3044 997 247 2351 3095 315 
1 14 220 612 468 2867 405 229 3181 1617 278 1639 806 942 2879 700 
1 12 220 597 751 81 36 1607 948 1939 1379 349 1067 384 
1 8 278 3195 303 3208 606 2866 293 768 
1 31 278 3188 3180 3172 364 446 919 197 27 3168 83 470 653 2815 1499 478 1797 160 701 3132 181 1152 481 98 373 793 1837 88 2351 3095 315 
1 13 1499 1998 632 201 900 922 2271 2018 141 1024 2785 127 1813 
1 6 1030 217 240 1098 472 2355 
1 9 220 2408 1130 2946 717 2032 691 1027 2913 
1 14 792 1016 1539 2086 1988 280 3167 381 1379 398 1664 293 1351 377  
1 14 2271 628 841 3197 2067 508 5 1918 638 330 237 843 3216 3217 
1 10 2110 1638 2729 1712 2938 620 1035 2929 51 1141 
1 8 2018 84 57 616 129 497 471 756 
1 4 793 895 2095 1636 
1 5 2317 2595 4744 1434 2500 
1 21 4629 4594 4608 2442 4595 4623 4656 2655 4735 4703 4714 4734 1879 179 4641 1677 4660 4637 4606 2569 4607 
1 12 4186 4155 823 1416 4065 4057 1518 4074 4080 2618 4131 4162 
3 35 3053 3048 3043 3030 2028 3012 708 3011 3007 3003 2995 1600 3004 2502 1640 3017 3023 1963 1435 3042 3054 3071 3081 3091 308 3108 808 1914 3098 2035 3107 3100 1817 1937 3064 
1 2 3064 3053 
1 6 869 3061 3077 3088 2035 3107 
1 5 869 1917 1825 1963 1435 
1 8 869 3041 3050 3059 3049 3053 3048 3043 
1 4 869 2323 602 1600 
1 13 6386 6368 2873 2369 6280 6282 6264 6245 1109 6216 6195 905 6140 
1 3 6195 6169 6175 
1 9 6175 6179 6170 1182 1430 6176 86 6106 6066 
1 6 6175 1680 6094 1421 2068 825 
1 29 6342 1261 6407 1889 6460 6486 2603 6522 6514 1402 6566 640 6536 2610 1124 6462 6499 6498 6494 766 6513 6525 6544 2179 1900 769 6614 6630 2887 
1 15 6562 743 6571 1767 6573 2072 1704 520 165 6616 6613 334 6620 6603 6609 
1 9 6741 6744 2726 6738 6740 6743 6745 887 6734 
1 7 2726 6748 2807 6753 6754 6755 1965 
1 5 6738 6732 1994 1950 2312 
1 10 6648 1612 6657 6664 6671 6679 6684 2830 2262 6696 
1 13 1663 1575 2272 2313 1308 2687 6700 6692 2336 6678 6681 6683 6672 
1 12 6692 68 6682 6680 6669 6663 829 670 6652 871 802 6641 
1 4 670 6647 6642 2788 
1 7 1040 6490 6484 6512 6526 2892 6540 
1 5 6566 2201 6594 1510 6577 
1 5 6342 6336 2554 6371 6392 
3 12 1073 1028 4391 4436 858 1690 4483 1207 4540 2848 4541 2880 
2 13 4469 4506 4534 4562 2497 2446 4510 4528 493 4548 2133 4477 4450 
1 7 4390 4351 4316 4283 2405 4214 1863 
2 18 6386 6368 2873 6308 6291 6280 6282 6264 6245 1109 6202 6195 905 6140 6093 6115 6052 6092 
1 14 6062 6029 1570 6013 2170 6106 6124 1843 1182 619 6179 6175 6169 905 
2 13 6319 6342 6344 6366 6407 1889 6460 6486 6531 6541 6522 6514 1402 
1 2 1566 6514 
1 9 6566 1402 2771 640 6536 6517 2610 1124 6462 
1 4 1566 1594 2189 6536 
1 15 6472 1783 6526 6535 1564 6556 2847 6525 6544 6561 1900 769 6619 6630 6638 
1 7 6525 6513 766 6494 6498 6499 6462 
1 6 6573 2072 1704 520 6571 743 
1 13 520 165 6616 6613 334 6620 6609 6603 6575 6554 6537 1551 6505 
1 10 1734 6741 6744 6748 1554 6746 6743 6745 887 6734 
1 2 6748 306 
1 5 6730 1994 6732 6737 1734 
1 23 2262 2830 6684 6677 6668 6661 2298 2390 1484 6651 1612 6655 1329 6654 6656 829 6663 6669 6680 2418 6673 6675 6678 
1 7 6680 6682 68 6692 6693 2687 1493 
1 5 6680 2489 6687 1308 2687 
1 8 847 109 791 1727 2759 6246 305 6309 
1 11 4036 4017 1815 3971 3952 3925 1419 3863 873 1037 3766 
1 7 49 913 2869 1342 551 3603 995 
1 2 4186 4162 
2 4 4548 1565 4560 136 
2 10 136 4472 1590 4414 1362 4322 11418 4274 1887 1314 
2 3 136 4551 4582 
1 6 4315 2255 4322 4302 1372 459 
1 2 4196 459 
1 2 4315 4357 
1 2 976 4313 
1 2 976 123 
1 2 4294 4273 
1 2 4236 4273 
1 2 1243 4171 
1 2 2690 1580 
1 2 4096 4120 
1 2 1382 4066 
1 4 4054 4082 4108 4138 
1 4 2074 4180 4154 4129 
1 3 4129 4153 1983 
1 4 1983 4176 1345 4152 
1 5 4152 4118 4081 4063 635 
1 3 3978 1711 2605 
1 3 2605 1063 4056 
1 6 4056 2875 2412 1596 4197 4211 
1 8 4211 4173 1177 4146 4112 4103 4126 4160 
1 9 4160 1343 4174 236 4231 4261 4304 4323 4340 
1 5 4323 4360 4407 4437 4468 
1 4 4468 2382 4502 4511 
2 10 4683 2654 4664 4658 4670 897 1420 4643 2730 493 
1 4 897 4708 4727 1434 
1 5 4582 4559 4592 4627 2317 
1 7 4316 4351 4390 2383 1967 4482 4500 
1 4 4741 2723 1344 24 
1 3 4634 1370 4621 
2 3 4129 2660 4064 
2 10 4985 5005 5035 5076 1609 2174 5213 1829 2346 2794 
1 8 2794 5374 2330 5402 872 2054 2597 5324 
1 6 872 5469 93 5523 2333 5562 
2 6 2794 5412 5440 5470 5510 323 
2 3 2794 5403 2665 
2 27 4882 1662 4954 4988 5017 5052 1893 762 5079 5111 2104 1608 5118 268 1494 417 2177 5157 1922 786 566 1595 1694 4922 747 4898 277 
2 16 4382 1645 975 4466 4494 2473 233 1223 4652 4693 4694 4681 2282 4698 4669 4682 
1 7 2473 4522 4550 4515 826 4499 461 
2 14 5728 5776 5813 5834 2670 158 5925 5942 2376 1193 6051 6091 287 6185 
2 4 5017 5053 2527 1160 
1 6 5380 5415 5418 702 5364 5359 
2 6 4610 4581 2245 4564 4553 1655 
4 2 5618 5585 
4 7 1153 1573 5602 5618 2521 5672 5634 
2 9 4590 4574 4539 4521 4498 4478 1976 4444 4458 
1 7 1595 4998 5041 5080 5116 5086 5128 
1 12 2840 5473 1583 5448 5433 5417 5392 5378 5352 2266 5310 5293 
2 10 4610 4588 2058 4531 2712 4458 4425 1977 4342 4309 
1 10 3481 193 3531 3566 3602 1852 3663 3709 3754 2006 
1 7 4985 773 5067 2886 116 5115 657 
1 5 657 5147 1627 5173 5148 
1 7 2665 1945 5435 5441 5479 5480 5514 
2 3 5514 5527 154 
2 2 154 2682 
1 5 2682 2897 5611 5640 5655 
1 3 5655 5684 5702 
1 2 1735 2642 
1 2 2642 5919 
1 7 6171 6108 344 6025 5986 1776 5919 
1 4 5702 5730 2679 5778 
1 4 5778 1929 5820 1735 
1 9 657 5172 5207 5261 106 5356 5388 5369 1729 
2 4 1729 5416 1108 154 
1 12 1323 1400 6007 5972 5947 2615 1707 5882 5855 2234 5832 1735 
1 6 1735 5832 2234 2141 2250 5831 
1 5 372 5712 5729 1267 930 
1 3 930 2009 5831 
1 8 372 5754 2365 5843 5875 2198 5970 1323 
1 6 1323 2632 6117 2358 2748 6225 
1 5 6225 1278 2475 1433 6209 
1 6 6209 2413 455 72 1768 6171 
1 6 6171 6165 450 2524 6101 2874 
1 5 5702 5742 1187 5845 5877 
1 8 5877 1191 5920 2577 2186 1870 763 2874 
1 13 5148 5193 2622 1765 838 5407 5445 5481 936 5544 5601 5641 5702 
1 5 1323 6045 6078 2306 6121 
1 2 6121 2835 
1 4 114 6217 1927 1700 
1 2 6121 2835 
1 2 1700 2835 
1 2 1700 2835 
1 6 6343 627 6273 2802 1232 1700 
1 4 6343 6361 6384 2620 
1 2 1700 2835 
1 15 1705 5083 5120 2433 5236 579 5354 5386 5426 5485 5520 2450 5606 5657 720 
1 7 720 108 2518 5825 5873 5895 5923 
1 16 5923 5945 5975 2777 6083 2810 6182 6205 2128 1586 2156 1732 2453 2530 6384 2620 
1 6 2620 6416 6394 6420 1103 6405 
1 7 6405 6413 6412 188 6399 6389 6363 
1 6 323 5638 959 5630 1378 930 
1 7 1705 4967 4931 2299 1856 4835 2758 
1 6 1705 2520 4993 2155 4994 5002 
1 10 5002 4950 2891 4869 4826 4799 2638 1867 2069 2799 
1 4 114 6240 6265 6278 
1 7 5831 5859 5893 2341 2360 5972 6007 
1 6 635 4008 4000 2476 981 4025 
1 10 4025 1221 587 1710 1238 1504 1258 2813 2713 3938 
1 4 3740 3711 3665 3633 
1 10 3633 3596 2005 361 1542 3465 3445 3419 3404 3379 
1 8 3379 3384 338 3380 3371 3330 2206 832 
1 9 832 3272 3278 3281 3301 2859 1280 3307 3283 
1 4 3283 3297 1502 2628 
1 3 3376 961 3399 
1 4 2151 3462 2590 3399 
1 5 2151 3555 3618 9 3717 
1 6 3717 1099 3716 1695 2774 3739 
1 5 3739 3776 3809 951 3909 
1 5 3909 1492 1745 2285 3978 
1 5 4064 4044 4016 2792 635 
1 8 2894 3778 3807 3867 3891 1353 2131 587 
1 9 3938 3903 1266 1682 3818 3793 190 3752 1137 
1 6 1137 2671 1761 1529 1658 2894 
1 6 3740 3712 2403 3691 2501 752 
1 7 752 2509 3635 3609 3570 1360 1043 
1 6 1043 1954 3480 732 3467 1944 
1 9 1944 2800 3437 3417 132 3398 3372 1519 2628 
1 7 3281 2118 3355 3382 918 3436 1944 
1 9 3379 3384 338 3420 827 3451 3501 2534 1043 
1 4 3752 2091 3781 3774 
1 3 3774 3770 3778 
1 5 2894 3756 3762 2231 1720 
1 6 1492 3908 3886 3871 3892 3875 
1 6 3739 3684 3668 1878 3598 3560 
1 4 2792 3988 1715 3978 
1 3 4071 4087 2893 
1 2 4225 4203 
1 2 1716 4069 
1 4 1131 4082 1598 4101 
3 8 4478 2841 2668 4403 4375 4347 4369 2787 
3 6 5627 5626 1303 1803 5587 5608 
1 6 4652 4640 4614 1635 4578 4550 
2 6 2571 689 1038 4615 121 1655 
2 6 1655 2716 984 4411 916 1055 
2 5 4321 4355 2797 4402 4411 
2 7 1055 4276 4300 4321 261 2589 4309 
2 7 4309 87 4288 2434 4223 4194 4150 
2 7 4223 4248 4282 1111 4311 4328 4369 
2 6 4369 2787 2301 4459 1200 2381 
2 4 2381 2496 4569 4590 
2 6 4590 1208 4661 4692 4737 4770 
2 8 4770 2838 4816 536 890 973 2218 277 
2 7 277 4871 4907 2426 1454 4966 5008 
2 4 5008 5042 5081 417 
2 7 417 650 5184 5216 1789 5314 5352 
2 6 5352 1107 1020 1848 2717 5546 
1 2 4569 4597 
1 2 4425 1172 
1 3 4723 4705 4668 
1 2 1527 4821 
1 2 1527 2838 
1 7 1595 348 4946 2793 4875 722 4853 
1 3 4976 4935 4898 
1 2 417 1858 
1 3 101 1982 5042 
1 3 101 5027 5008 
1 2 1982 5027 
1 2 5027 4980 
1 2 5186 1494 
1 2 444 5180 
1 2 5274 5251 
1 6 4668 2220 4625 2407 4611 4574 
2 7 4610 4639 4668 414 2143 4753 4770 
2 11 4770 1157 4821 4853 4889 4934 2109 2898 2505 645 5128 
2 10 5128 2528 5230 5268 5333 1801 2205 5443 5472 2840 
1 4 5116 2738 5175 5209 
1 8 5268 5255 5291 5306 5326 1773 5377 5433 
1 2 5377 5433 
1 2 2882 5268 
3 3 5728 2015 5642 
3 9 5728 1012 5705 1487 5693 5685 5656 5650 5627 
3 6 5627 5589 5561 5532 5511 2840 
3 6 5627 5669 2630 5715 5698 440 
3 4 440 5697 5633 5608 
3 5 2840 5507 5506 944 5608 
1 2 5702 2122 
1 2 5608 1391 
3 5 5642 1153 5546 5518 5497 
3 5 5497 5458 1060 5399 5359 
3 7 5359 2130 5274 5232 5180 5142 2104 
3 6 2104 2778 5013 1920 4899 2694 
2 8 2694 4854 1897 4803 2221 4757 4717 4682 
1 3 4669 2741 4602 
1 3 4773 4730 1892 
1 2 4730 4694 
1 2 1892 4681 
1 2 44 4681 
3 2 4930 1920 
4 3 5686 5643 5602 
4 3 1153 5625 5643 
4 3 1573 5625 5662 
4 5 5642 5662 5686 5694 5731 
3 4 2064 1888 5724 5694 
1 2 6087 1328 
1 5 6037 1872 6086 6113 6091 
1 6 1848 182 1326 740 5651 1487 
1 8 5359 2050 864 5393 5429 1876 2755 1848 
1 2 5221 1922 
1 2 2368 5216 
2 6 4403 248 4479 2519 4508 2381 
1 2 4738 2117 
1 4 4738 4754 4785 973 
1 6 1940 2625 2828 5886 242 5942 
1 11 6783 6782 5519 5490 5499 5459 5463 5419 5384 5341 5340 
1 5 5430 1213 2007 6781 5419 
1 3 5519 5512 5475 
1 5 764 5136 5143 2238 2527 
1 2 133 329 
1 2 4797 4776 
1 2 2649 1584 
1 2 2816 4468 
1 2 4240 4279 
1 3 2412 4121 2875 
1 3 1353 3930 1667 
1 3 3875 3858 3831 
1 2 1806 3738 
1 4 3522 982 3568 3606 
1 3 1047 3562 2325 
1 4 1289 3455 3426 1230 
1 3 3808 3835 2588 
1 3 1195 1739 1676 
1 5 3876 3857 3830 3792 3773 
1 3 1954 3521 502 
1 2 3694 3715 
1 2 3695 3646 
1 4 2883 3924 3904 2764 
1 9 2154 2249 4964 1948 4957 4951 2463 4965 4985 
1 12 5562 5580 224 5598 5597 5615 5619 5628 589 5652 5666 108 
1 10 5324 1054 5228 5196 1614 5098 5045 5010 4969 2154 
2 16 1323 2030 5934 5931 5941 1046 5946 5930 2214 5937 5960 692 5968 5929 5927 2678 
1 2 5923 2678 
1 6 6363 1637 6305 6289 2423 1708 
1 7 6309 6296 2499 6341 6345 6363 6389 
1 12 1708 6229 1531 6173 2881 1935 6076 6038 6015 733 5944 5923 
1 13 5002 2240 5058 2113 1248 5132 5154 2677 1318 5239 5258 694 5324 
1 2 2889 1107 
1 10 5079 5119 2197 5210 1760 2683 5315 5348 5383 5418 
1 8 1848 2487 5528 5536 2046 903 1835 5561 
1 9 1487 5693 5718 5736 990 5822 1403 1962 1940 
1 4 1120 1764 524 4021 
1 8 427 161 32 726 501 6161 746 6246 
1 11 1082 2042 1309 13 59 556 5898 696 1312 119 226 
1 8 5491 210 800 972 319 4796 64 767 
1 5 1854 369 4990 578 41  
2 100 4763 2743 118 25 539 559 1723 8 760 163 1116 32 1786 1532 5674 830 2163 1145 5529 2819 821 5554 5570 5605 5614 1025 5703 5737 2175 5758 5790 1966 2860 5745 1074 1532 5645 5603 1222 5482 5447 5409 1903 5385 5353 5321 5294 5330 5360 1792 5372 5400 5437 5476 2300 5520 2450 5576 2277 5582 5550 761 5477 5438 5381 5350 1834 5354 2012 5372 966 5450 5493 821 2202 1245 5695 5726 5745 5766 5789 1769 726 1117 5840 940 109 5959 866 1924 325 1523 447 894 143 1359 272 441 1850 5420 
1 28 6329 2681 1755 2273 6310 6305 1015 6292 2499 2316 745 6436 6456 6433 167 1550 914 2568 633 447 894 23 5952 1397 272 463 1072 847 
1 17 272 463 1072 847 1276 8 856 774 427 669 1029 2782 5130 5102 5103 5113 82 
1 34 5021 149 5126 723 2056 654 1315 558 5569 91 1276 109 791 1727 2759 6246 305 6309 6296 2499 531 6323 1637 6351 1873 169 2850 6352 1772 2691 6394 6439 6469 6492 
1 31 1407 2042 633 325 866 791 614 726 1769 1911 5814 1807 5848 5849 5863 5852 1377 968 979 5824 5825 5841 5806 2125 1652 266 5774 5746 2804 1722 5701 
1 14 5728 1012 1042 740 2053 1751 5536 2783 5392 1101 1220 5292 5262 5221 
1 14 2882 2528 5175 5149 1622 5124 566 1384 1385 1048 341 1454 4911 2697 
1 7 5497 5457 5429 5379 5398 1216 5352 
1 9 5472 5422 2310 174 1773 1220 5299 5262 5221 
1 10 5546 2717 182 5545 1751 5595 2001 5617 5612 5589 
1 9 5418 702 5347 2683 1760 5210 2197 5096 762 
1 6 5186 1176 867 1244 985 5274 
1 8 4723 609 4801 4823 1317 1352 4902 4934 
1 6 5306 5250 5231 5195 5149 1622 
1 9 2828 2625 5879 1403 5837 5816 5775 5750 2630 
1 6 2828 1349 5797 209 5751 1012 
1 5 5834 1556 5835 2427 5731 
1 7 1538 2207 3699 3730 3759 724 710
1 6 3905 3894 359 629 3823 1037
1 2 3768 913
1 2 3580 3602