1 18 1539 6577 1788 688 2074 414 3967 626 2621 6686 6677 6684 3864 6645 2291 6618 2562 6639 
1 13 1788 6566 6537 1162 6500 185 4099 1086 1197 2759 1175 2525 6431 
1 23 1175 6362 1114 6286 1413 297 2645 1452 2814 6035 748 5968 5934 840 5886 3522 2943 5780 5741 907 5707 896 2626 
1 7 6876 6832 1117 6773 6747 6724 6684 
1 10 1825 7122 7089 501 3465 7002 6973 6940 1087 6876 
1 10 5412 3825 5473 5480 2782 3660 5563 2438 3630 5630 
1 15 5087 307 5147 5169 5203 1929 23 5261 5295 2662 5358 5387 5415 5438 723 
1 6 5533 5516 1754 5442 5411 5387 
1 12 1671 5547 2967 5646 786 2464 5748 5732 2596 1173 5772 2455 
1 5 5599 4069 5564 812 5480 
1 10 2165 762 5847 898 5831 5812 5799 5786 5764 5745 
1 10 2265 551 2594 5417 3644 5397 1591 3608 5425 5480 
1 11 1447 4869 1099 4824 2439 2364 387 4756 4777 1341 371 
1 17 6031 2862 105 211 5952 223 1967 5984 3811 1030 490 3294 240 2063 1571 237 6197 
1 12 5741 2396 3192 55 3057 5636 3 5605 969 5569 411 2967 
1 5 3294 190 2852 5954 2158 
1 23 185 1823 6433 6412 1829 6369 2048 6318 1462 6247 3787 2823 6137 3214 6068 6034 6018 1569 5974 2608 3194 5842 5815 
1 17 7131 1772 7080 530 330 2680 6904 1498 6828 2638 3375 6737 6746 6720 765 6662 2115 
1 46 1498 1161 3099 6853 6877 1863 3460 6935 408 3755 612 2936 34 7042 654 3500 7095 2100 198 7112 1355 7090 1642 7072 564 7120 7149 7150 756 7190 2537 7182 7189 485 1832 7224 2671 872 7259 1025 7287 3274 2732 7352 3840 7403 
1 30 564 3440 7041 7016 235 6976 6938 6910 3494 2467 113 2893 63 3117 3491 2006 3108 1560 3711 4 3534 2250 6627 3199 1022 2761 6657 6673 6672 61 
1 13 6877 3539 6816 6798 410 1636 6710 1931 6666 380 202 6617 1083
1 7 3590 7210 1662 3155 7141 4054 3818 
1 6 1872 4030 1200 2900 2185 4054 
1 10 6909 6930 1250 1209 2769 7061 7083 886 7108 7141 
1 25 7225 7237 3429 7242 7263 7276 4014 1293 203 2590 7361 3145 3009 3806 3542 7316 7301 7313 2791 2763 7375 1677 7413 7422 76 
1 8 2983 2774 4043 1307 7325 7338 7329 2791 
1 4 7419 7402 7386 2590 
1 13 779 2391 2855 7383 1424 1390 3142 7337 7333 7311 7303 7324 1213 
1 3 1708 3503 1424 
1 9 7546 2237 304 2781 7543 7541 1255 7530 3564 
1 7 7535 7539 2649 2107 7542 3172 2781 
1 9 7512 1964 7500 7493 911 7486 7479 678 7472 
1 9 7522 2509 7515 518 3418 2569 7501 7496 678 
1 8 3023 1308 7509 3880 3234 7504 2974 2569 
1 16 2637 3339 984 3720 4003 4163 4172 1733 2550 4270 4317 1521 4384 4423 2917 1080 
1 7 1860 4460 430 4446 1673 1878 1521 
1 14 4291 74 4275 3667 1857 4063 1548 1604 2459 4292 464 833 3140 3893 
1 8 4270 4289 4272 1470 4261 837 4236 3893 
1 18 4238 698 4182 4201 777 4203 4211 4207 4231 4217 4248 1073 4247 895 4281 887 4300 4270 
1 9 1447 2201 3473 3513 2981 1888 3448 1519 3832 
1 8 5397 5369 5341 5317 1048 4092 81 1607 
1 4 3130 2850 5356 4087 
1 35 5629 1058 5650 1710 5583 3596 834 3538 1132 5348 998 5281 3072 3399 5193 1691 5142 2431 2518 41 5059 1068 5069 818 2220 1886 853 1443 2233 2034 1602 3352 3746 2544 951 
1 4 951 5499 5468 3091 
1 8 291 6496 2356 226 6389 6366 3964 2124 
1 10 6889 6873 1592 6848 2520 6829 6812 6803 6796 6773 
1 16 353 4792 1846 4830 4847 259 2914 2029 4891 4912 2682 1808 1979 3134 267 917 
1 19 4450 3060 4477 1577 4512 4553 1596 2283 4651 2702 2829 4697 2508 3871 4775 4815 4842 2767 4912 
1 31 5072 3747 5027 4084 751 4948 4931 3937 117 4854 4849 2154 645 4809 1317 1504 949 4742 4734 1388 247 4706 2951 706 2490 2925 4596 4579 1896 2368 1577 
1 25 393 2019 4142 1223 4159 4171 3356 4229 681 250 1488 4419 4445 3935 3255 1617 1069 4615 4639 3338 1195 4746 1370 1310 4849 
1 20 4634 142 3005 442 4623 1542 4064 2918 581 4517 4495 1853 72 3599 1491 2270 4353 4330 4344 4340 
1 13 72 4467 4493 4513 764 4519 49 4555 4548 450 1005 3143 3935 
1 31 4435 3572 4421 3128 740 4468 797 4490 184 1047 2607 4485 4520 4498 4486 496 1017 4474 1605 2170 4543 2737 979 4554 1231 4539 97 1500 2288 4621 4651 
1 23 2036 51 3943 662 5242 217 5260 5296 5312 1997 1727 5365 3727 5410 1739 354 3785 5437 5433 2693 5439 3148 5427 
1 15 642 5931 1221 5843 364 2987 2308 5709 5682 3968 3206 5566 5535 2024 2693 
1 15 956 1601 3259 3470 5647 489 5615 5586 1499 1259 5465 1517 3240 2060 5312 
1 18 3361 1644 2397 589 1947 2142 2197 1655 3959 458 5902 1277 5805 1729 2206 1717 2860 3968 
1 8 3519 5165 3962 5216 1104 5287 5292 1727 
1 17 3377 3188 1429 1867 2362 1544 5959 3348 2978 346 6119 6161 6185 2915 1426 2587 2124 
1 11 6250 3697 3670 396 3233 1085 6145 3157 6073 6079 800 
1 12 5830 221 5845 1428 5825 455 3087 5794 3433 261 2578 2224 
1 7 223 5881 5838 934 1456 5702 5685 
1 10 3361 6321 6351 1094 1845 6444 6470 6519 6536 1560 
1 13 6450 6440 6452 6429 6420 6422 58 899 6399 6381 101 3381 2726 
1 6 1094 2325 2130 2777 301 2726 
1 17 3519 5108 2389 3416 1584 3499 5099 2014 5104 656 3675 5079 5021 4976 4953 1469 2029 
1 10 917 5061 2500 106 2127 5138 1940 5167 5195 853 
1 8 5745 978 5718 1759 2863 5685 32 5599 
1 2 5702 5685 
1 5 723 417 1671 2202 5599 
1 10 1048 5275 908 5240 3405 5190 1122 2257 5128 1888 
1 8 1929 1036 5247 1211 2263 5267 622 2297 
1 19 2544 1346 1198 2436 435 1235 2837 535 4047 2754 5389 3546 846 671 2945 274 3213 1526 5427 
1 21 740 3551 4536 4585 4618 4648 4673 1070 2468 4765 4789 1400 992 587 1106 4961 2512 3325 1726 1715 5108 
1 4 1149 3179 1166 6250 
1 14 6318 3514 6332 6326 6324 1620 1082 2794 6345 6367 6408 6413 6415 6389 
1 11 3399 2037 1782 2810 5120 541 3301 5056 5036 1364 4948 
1 7 2224 702 2632 5853 5890 77 642 
1 9 654 3954 1895 3242 7215 7234 1437 7298 1796 
1 9 1796 2698 2891 7387 1514 7412 3198 599 2489 
1 11 6318 3324 6380 1281 890 6468 6511 2195 6560 1187 6618 
1 6 2823 6097 1288 345 2082 1948 
1 3 3967 6725 2772 
1 15 1796 7357 1216 2744 7401 7432 1821 7443 3250 1930 970 3292 1719 7485 2727 
1 12 3242 3797 7187 7175 7183 7197 7188 2116 7216 7214 7228 7217 
1 11 501 7032 913 3588 2604 290 7052 610 7064 2109 7096 
1 2 7096 175 
1 15 3361 685 3427 48 6199 2999 1354 6143 2861 2009 1763 2864 1713 996 6070 
1 7 834 2664 1034 2779 861 5656 2292 
1 8 4555 4604 46 493 4065 116 233 778 
1 16 1017 4095 4428 1109 3508 4351 565 4314 2222 4262 3067 3443 710 4178 4060 4166 
1 8 5748 2622 1621 2232 3516 1800 3533 223 
1 6 3660 5585 3729 5667 5695 5745 
1 5 2653 2745 5665 3824 280 
1 6 2653 5751 5769 5742 5770 2167 
1 10 5059 5033 4954 2256 4864 3409 1313 343 4735 4706 
1 8 2544 512 5582 5616 5633 5670 5696 2033 
1 2 3130 4087 
1 15 3935 4470 618 3397 1092 4393 1296 3583 4360 4379 2320 4370 2982 4349 4387 
1 6 1788 902 2585 572 6633 6609 
1 3 6537 639 6554 
1 10 6466 3724 2683 3761 732 6414 472 3973 2602 2242 
1 7 1926 4040 1854 3196 6549 2213 6527 
1 24 6473 6493 915 6482 1926 6464 6467 3479 2213 6517 291 500 3000 6608 2115 3290 1753 3581 1474 6625 2394 6632 2487 6639 
1 2 3825 5461 
1 5 3429 1196 3426 7176 1137 
1 8 6909 6946 6926 3504 3930 6987 3669 1200 
1 10 1447 1720 1121 4883 2616 4886 2328 4906 437 3518 
1 3 2626 3632 2959 
1 5 2626 2046 1998 3387 2018 
1 6 5799 5816 843 5867 5887 5928 
1 4 3691 3095 6455 6473
3 4 6472 3895 6400 2409 
2 5 1083 6542 2498 1485 6472 
3 7 2409 1589 6370 2160 1149 2284 3691
2 8 6472 889 6453 3002 6459 6471 652 6450
2 5 6472 6460 3306 3557 6455
1 20 2090 758 1439 6306 3847 2363 1118 6364 164 6419 961 6483 6506 1575 1970 421 1449 3834 3888 1022 
1 12 2363 2475 2337 547 1652 3447 3483 6476 3467 3063 6507 6519 
1 15 3250 2902 1547 481 4009 2125 7331 2209 7297 2065 3200 3735 7245 7241 1832 
1 21 6673 127 6702 2765 1343 6781 1593 2905 6887 2012 6960 6996 7027 7018 7071 1154 1325 1436 7172 3517 1832 
1 19 113 294 1416 670 6732 6704 212 3783 1283 6682 6659 6660 6650 971 6651 6661 432 1849 6617 
1 10 3675 5141 365 1638 1619 3692 5304 231 3759 2754 
1 13 2036 1191 2546 215 1459 5014 2113 4949 2575 4888 2572 992 1400 
1 13 2036 5236 5289 1495 5359 2842 3849 2830 156 5575 5624 5654 956 
1 17 2363 3635 3654 931 1758 2861 2009 1170 5975 5956 5921 3915 5819 5791 5746 2771 956 
1 9 4387 926 3812 1810 4402 1882 4451 3434 4450 
1 13 4166 1507 4234 653 4298 3238 3088 730 2589 4418 4449 3060 4450 
1 15 917 1667 3174 1193 2964 1959 4882 4874 4844 4816 4793 3411 4743 4722 4706 
1 14 4706 247 3335 4653 3703 342 4564 2244 2218 2073 4483 2445 4431 1296 
1 9 6408 570 2531 75 2007 1861 1645 1880 6618 
1 12 2978 6085 2941 3441 1103 3262 1026 1135 6090 3869 2942 6068 
1 9 185 6515 3462 6555 603 2286 2360 478 6684 
1 13 6746 1268 276 2960 39 1976 1612 6957 2221 6990 7028 2604 3588 
1 10 6617 6648 6706 3594 2667 6823 2856 2028 6950 2936 
1 8 6666 6649 6622 2312 6599 2700 6580 6579 
1 16 800 6129 2699 1133 6207 2721 6237 6263 6261 994 2770 6292 1549 2764 6353 6381 
1 11 458 253 6032 2042 6100 2716 796 6222 6228 6261 6263 
1 3 5516 502 3 
1 5 786 3831 5701 5724 1456 
1 5 5745 171 717 5690 5713 
1 8 1929 5268 5309 214 1254 1528 5449 5471 
1 5 3405 5274 3745 5337 3608 
1 10 371 1756 4832 1991 3033 625 4921 2586 266 2684 
1 5 5358 5330 5303 5273 5263 
1 2 1519 5249 
1 5147 2993 3659 2491 5123 
1 4 2981 692 5082 1659 
1 7 5169 3505 3999 5139 5100 5073 3485 
1 4 4084 4969 4987 5016 
1 3 778 487 2927 
1 4 4906 4879 1973 3610 
1 6 1030 6041 6064 6106 6086 1600 
1 5 5857 367 3684 2446 1967 
1 10 3630 5558 5539 5513 2026 2594 5384 3244 5338 5322 
1 13 5615 2416 1923 5722 3838 763 2522 2184 5836 2223 2496 3396 458 
1 6 1575 213 1077 3774 3156 2486 
1 14 6673 6691 959 336 3191 1942 375 1935 6819 3686 1608 3135 2373 6965 
1 7 7259 1423 2351 7198 7180 2817 3431 
1 7 2209 1396 2183 3001 7391 2524 7409 
1 5 330 3181 7029 3877 7039 
1 5 7183 7161 3211 7103 7075 
1 6 39 647 6880 2005 6842 661 
1 5 39 6925 6966 6980 7010 
1 5 3375 2646 6695 1415 877 
1 7 1642 2627 4070 1525 6900 3015 6831 
1 12 7112 859 2742 2920 7226 534 2313 7326 66 4058 1703 1547 
1 7 7298 2176 3303 2361 7291 7304 2313 
1 9 7228 1570 1813 3816 2988 2128 7336 4055 1514 
1 13 58 2310 20 4018 640 6545 1531 3323 6621 6644 1987 6703 6732 
1 7 5348 5350 1781 1278 2969 138 3388 
1 4 5629 1368 5557 5529 
1 4 3091 1159 5493 2558 
1 6 2915 2547 6215 1153 6230 6254 
1 4 6250 482 6251 4073 
1 3 800 6040 761 
1 4 2632 1692 885 137 
1 5 1677 7393 2040 7394 59 
1 2 3145 7354 
1 4 203 7317 921 7280 
1 4 7329 3225 7292 1407 
1 14 7333 4105 7346 2530 2391 904 3650 7429 1708 4081 7430 1220 228 1390 
1 6 7413 585 7374 7371 333 7325 
1 4 6946 6977 7015 7044 
1 3 1662 3717 7159 
1 2 7061 506 
1 3 518 1045 1432 
1 6 7530 1230 7528 1949 1433 2107 
1 8 1087 2174 6864 1509 6772 6784 2070 661 
1 6 6772 1653 3653 3972 3121 6618 
1 7 6876 6892 6918 2400 2123 3898 7014 
1 8 1620 1270 4031 1008 6186 6156 6121 6090 
1 13 6555 3195 2298 6477 752 6512 2437 6468 2584 6424 2010 2287 1082 
1 8 2794 944 6244 3955 2097 1269 6149 553 
1 6 6369 6359 3475 2566 1994 3369 
1 11 1197 6363 873 6265 3813 6188 292 6115 771 2334 2814 
